NO ./textures/tex5.xpm
SO ./textures/tex3.xpm
WE ./textures/tex2.xpm
EA ./textures/tex4.xpm

F 172,25,25
C 163,208,255

111111111111111
100000000000001
10001000E001001
100000100010001
111111111111111

