NO ./textures/tex5.xpm
SO ./textures/tex3.xpm
WE ./textures/tex2.xpm
EA ./textures/tex4.xpm

F 224,172,105
C 205,249,255

			1111111111111111111
			1000N00000110000001
			1011000001110001001
			1011000000000000001
			1011000001110000001
			1000000000110000011
1111111111111000000000000001111
11110111111111011101010000001
11000000110101011000000000001
10001000000000000000000000001
10000000000000001101010010011
11000001111111111111011110001
11110111         111011110001
11110111         111111111111
11110111111111111111111111111
10000000000000000000000000001
10110000011100010000000010001
10110000000000000000000010001
10110000011100000000000010001
10000000001100000111011110001
11110111111111011100000010001
11110111111111011101010000001
11000011001010101100000000001
11111111111111111111111111111
